150
10
30  0  0  0  0  0  0  0  0  0  0  0  3 33 33 33 33 33 33 33 33 33 33 33 33 33 33 33 33 33 33 33  4  0  0  0  0  0  0  0  0  0  0  0  0  0  0  0  0  0  0  0  0  0  0  0  0  0  0  0  0  0  0  0  0  0  0  0  0  0 35  0  0  0  0  0  0  0  0  0  0  0  0  0  0  0  0  0  0  0  0  0  0  0  0  0  0  0  0  0  0  0  0  0  0  0  0  0  0  0  0  0  0  0  0 36  0  0  0  0 35  0 35  0 35  0 35  0 35  0 35  0 35 30 35  0 35  0 35  0 35  0 35  0 35  0 35  0 35 30
30  0  0  0  0  0  0  0  0  0  0  0  0 35 35 35 35 35 35 35 35 35 35 35 35 35 35 35 35 35 35 35  0  0  0  0  0  0  0  0  0  0  0  0  0  0  0  0  0  0  0  0  0  0  0  0  0  0  0  0  0  0  0  0  0  0  0  0  0  0 35  0  0  0  0  0  0  0  0  0  0  0  0  0  0  0  0  0  0  0  0  0  0  0  0  0  0  0  0  0  0  0  0  0  0  0  0  0  0  0  0  0  0  0  0 33  0  0  0  0  0  0  0  0  0  0  0  0  0  0  0  0  0 30  0  0  0  0  0  0  0  0  0  0  0  0  0  0  0 30
30  0  0  0  0  0  0  0  0  0  0 30  0 35 35 35 35 35 35 35 35 35 35 35 35 35 35 35 35 35 35 35  0  0  0  0  0  0  0  0  0  0  0  0  0  0  0  0  0  0  0  0  0  0  0 30  0  0  0  0  0  0  0  0  0  0  3 33  4  0 35  0  0  0  0  0  0  0  0  0  0  0  0  0  0  0  0  0  0  0  0  0  0  0  0  0  0  0  0  0  0  0  0  0  0  0  0  0  0  0  0  0  0  0  0 35  0  0  0  0  0  0  0  0  0  0  0  0  0  0  0  0  0 30  0  0  0  0  0  0  0  0  0  0  0  0  0  0  0 30
30  0  0  0  0  0 30 30 30  0 30 30  0 35 35 35 35  0  0  0  0  0  0  0  0  0  0  0  0  0  0  0  0  0  0  0  0  0  0  0  0  0  0  0  0  0  0  0  0  0  0  0  0  0  0 35  0  0  0 30  0  0  3 33  4  0  0 35  0  0  0  0  0  0  0  0  0  0  0  0  0  0  0  0  0  0  0  0  0  0  0  0  0  0  0  0  0  0  0  0  0  0  0  0  0  3 33  4  0  0  0  0  0  0  0  0  0  0  0  0  0  0  0  0  0  0  0  0  0  0  0  0  0  0  0  0  0  0  0  0  0  0  0  0  0  0  0  0  0 30
30  0  0  0  0  0 30 30 30  0  0 30  0 35 35  0  0  0  0  0  0  0  0  0  0  0  0  0  0  0  0  0  0  0  0  0  0  0  0  0  0  0  0  0  0  0  0  0  0  0  0  0  0 30  0 35  0  0  0 35  0  0  0 35  0  0  0 35  0  0  0  0  0  0  0  0  0  0  0  0  0  0  0  0  0  0  0  0  0  0  0  0  0  0  0  0  0  0  0  0 30 30  0  0  0  0 35  0  0  0  3 33  4  0  0  0  0  0 30  0  0  0  0  0  0  0  0  0  0  0  0  0  0  0  0  0  0  0  0  0  0  0  0  0  0  0  0  0  0 30
30  0  0  0  0  0 30 30 30 30  0 30  0 35  0  0  0  0 35 35 35 35 35 35 35 35 35 35 35 35 35 35 30 30 32 31  0  0  0  0  0  0  0  0  0  0  0 30  0  0  0  0 30 30  0 35  0  0  0 35  0  0  0 35  0  0  0 35  0  0  3 33 33 33  4  0  0  0  0  0  0  0  0  0  0  0  0  0  0  0  0  0  0  0  0  0  0  0  0 30 30 30  0  0  0  0 35  0  0  0  0 35  0  0  0  0  0 30 30 30 30 30 30 30 30 30 32 32 32 31 32 30 30 30 30 30 30 30 30 30 30 30 30 30 30 30 30 30 30 30
30 30 30  0  0  0  0  0  0  0  0 30  0  0  0  0 35 35 35 35 35 35 35 35 35 35 35 35 35 35 35 35 35 35 35 35 31 31 30 32 31 32 32 30 32 30 32 32  0  0  0  0 35  0  0 35  0  0  0 35  0  0  0 35  0  0  0 35  0  0  0 35 35 35  0  0  0  0 30  0  0  0  0  0  0  0  0  0  0  0  0  0  0  0  0  0  0  0 30 30 31 32  0  0  0  0 35  0  0  0  0 35  0  0  0 30 30 35 35 35 35 35 35 35 35 35 35 35 35 35 35 35 35 35 35 35 35 35 35 35 35 35 35 35 35 35 35 35 35 30
30 30 30  0  0  0  0  0  0  0  0 30  0  0  0 35 35 35 35 35 35 35 35 35 35 35 35 35 35 35 35 35 35 35 35 35 35 35 35 35 35 35 35 35 35 35 35 35  0  0  0  0 35  0  0 35  0  0  0 35  0  0  0 35  0  0  0 35  0  0  0 35 35 35  0  0  0  0 30 30 30 30 30 30 30 30 30 30 30 30 30 30 30 31 32 32 31 32 32 30 32 30  0  0  0  0 35  0  0  0  0 35  0  0  0  0  0 35 35 35 35 35 35 35 35 35 35 35 35 35 35 35 35 35 35 35 35 35 35 35 35 35 35 35 35 35 35 35 35 30
30 30 30 30 30 30 30 30 30 30 30 30  0 35 35 35 35 35 35 35 35 35 35 35 35 35 35 35 35 35 35 35 35 35 35 35 35 35 35 35 35 35 35 35 35 35 35 35  0  0  0  0 35  0  0 35  0  0  0 35  0  0  0 35  0  0  0 35  0  0  0 35 35 35  0  0  0  0 35 35 35 35 35 35 35 35 35 35 35 35 35 35 35 35 35 35 35 35 35 35 35 35  0  0  0  0 35  0  0  0  0 35  0  0  0  0  0 35 35 35 35 35 35 35 35 35 35 35 35 35 35 35 35 35 35 35 35 35 35 35 35 35 35 35 35 35 35 35 35 30
30 35 35 35 35 35 35 35 35 35 35 35  0 35 35 35 35 35 35 35 35 35 35 35 35 35 35 35 35 35 35 35 35 35 35 35 35 35 35 35 35 35 35 35 35 35 35 35  0  0  0  0 35  0  0 35  0  0  0 35  0  0  0 35  0  0  0 35  0  0  0 35 35 35  0  0  0  0 35 35 35 35 35 35 35 35 35 35 35 35 35 35 35 35 35 35 35 35 35 35 35 35  0  0  0  0 35  0  0  0  0 35  0  0  0  0  0 35 35 35 35 35 35 35 35 35 35 35 35 35 35 35 35 35 35 35 35 35 35 35 35 35 35 35 35 35 35 35 35 30