150
25
0   0  0 20  0  0  0  0  0  0  0  0  0  0 35 31 31 31 31 31 31 31 31 31 38  0  0  0  0  0  0  0  0  0  0  0  0  0  0  0  0  0  0  0  0  0  0  0  0  0  0  0  0  0  0  0  0  0  0  0  0  0  0  0  0  0  0  0  0  0  0  0  0  0 36 31 31 31 31 31 31 31 31 31 31 31 31 31 37  0  0  0  0  0  0  0  0  0  0  0  0  0  0  0  0  0  0  0  0  0  0  0  0  0  0  0  0  0  0  0 31 31 31 31 31 30 31 37  0  0  0  0  0  0  0  0  0  0  0  0  0  0  0  0  0  0  0  0  0  0
0  51 59 20  0  0  0  0  0  0  0  0  0  0  0 35 31 31 31 31 31 31 31 38  0  0  0  0  0  0  0  0  0  0  0  0  0  0  0  0  0  0  0  0  0  0  0  0  0  0  0  0  0  0  0  0  0  0  0  0  0  0  0  0  0  0  0  0  0  0  0  0  0  0 36 31 31 31 31 31 31 31 31 31 31 31 31 31 37  0  0  0  0  0  0  0  0  0  0  0  0  0  0  0 51 59  0  0  0  0  0  0  0  0  0  0  0  0  0  0 31 31 31 31 31 31 31 37  0  0  0  0  0  0  0  0  0  0  0  0  0  0  0  0  0  0  0  0  0  0
52  50 53 54  0  0  0  0  0  0  0  0  0  0  0  0 35 31 31 31 31 31 38  0  0  0  0  0  0  0  0  0  0  0  0  0  0  0  0  0  0  0  0  0  0  0  0  0  0  0  0  0  0  0  0  0  0  0  0  0  0  0  0  0  0  0  0  0  0  0  0  0  0  0 36 31 31 31 31 31 31 31 31 31 31 31 31 31 37  0  0  0  0  0  0  0  0  0  0  0  0  0  3 52 50 53 54  0  0  0  0  0  0  0  0  0  0  0  0  0 31 31 31 31 31 31 31 37  0  0  0  0  0  0  0  0  0  0  0  0  0  0  0  0  0  0  0  0  0 0
56 49 55 58  0  0  0  0  0  0  0  0  0  0  0  0  0 35 40 40 40 38  0  0  0  0  0  0  0  0  0  0  0  0  0  0  0  0  0  0  0  0  0  0  0  0  0  0  0  0  0  0  0  0  0  0  0  0  0  0  0  0  0  0  0 51 59  0  0  0  0  0  0  0 36 31 31 31 31 31 31 31 31 31 31 31 31 31 37  0  0  0  0  0  0  0  0  0  0  0  0  0  0 56 49 55 58  0  0  0  0  0  0  0  0  0  0  0  0  0 31 31 31 31 31 31 31 37  0  0  0  0  0  0  0  0  0  0  0  0  0  0  0  0  0  0  0  0  0  0
0  48 17 18  0  0  0  0  0  0  9  0  0  0  0  0  0  0  0  0  0  0  0  0  0  0  0  0  0  0  0  0  0  0  0  0  0  0  0  0  0  0  0  0  0  0  0  0  0  0  0  0  0  0  0  0  0  0  0  0  0  0  0  3 52 50 53 54  0  0  0  0  0  0 36 31 31 31 31 31 31 31 31 31 31 31 31 31 37  0  0  0  0  0  0  0  0  0  0  0  0  0  0  0 57  0  0  0  0  0  0  0  0  0  0  0  0  0  0  0 31 31 31 31 31 31 31 37  0  0  0  0  0  0  0  0  0  0  0  0  0  0  0  0  0  0  0  0  0  0
30 30 30 30 30 30 30 30 30 30 30 32  0  0  0  0  0  0  0  0  0  0  0  0  0  0  0  0  0  0  0  0  0  0  0  0  0  0  0  0  0  0  0  0  0  0  0  0  0  0  0  0  0  0  0  0  0  0  0  0  0  0  0  0 56 49 55 58  0  0  0  0  0  0 35 40 40 40 40 40 40 40 40 40 40 40 40 40 38  0  0  0  0  0  0  0  0  0  0  0  0  0  0  0 57  0  0  0  0  0  0  0  0  0  0  0  0  0  0  0 31 31 31 31 31 31 31 37  0  0  0  0  0  0  0  0  0  0  0  0  0  0  0  0  0  0  0  0  0  0
31 31 31 31 31 31 31 31 31 31 31 33 30 32  0  0  0  0  0  0  0  0  0  0  0  0  0  0  0  0  0  0  0  0  0  0  0  0  0  0  0  0  0  0  0  0  0  0  0  0  0  0  0  0  0  0  0  0  0  0  0  0  0  0  0 57  0  0  0  0  0  0  0  0  0  0  0  0  0  0  0  0  0  0  0  0  0  0  0  0  0  0  0  0  0  0  0  0  0  0  0  0  0 11 48  0  0  0  0  0  0  0  0  0  0  0  0  0  0  0 31 31 31 31 31 31 31 37  0  0  0  0  0  0  0  0  0  0  0  0  0  0  0  0  0  0  0  0  0  0
31 31 31 31 31 31 31 31 31 31 31 31 31 33 30 32  0  0  0  0  0  0  0  0  0  0  0  0  0  0  0  0  0  0  0  0  0  0  0  0  0  0  0  0  0  0  0  0  0  0  0  0  0  0  0  5  0  0  0  0  0  0  0  0  0 57  0  0  0  0  0  0  0  0  0  0  0  0  0  0  0  0  0  0  0  0  0  0  0  0  0  0  0  0  0  0  0  0  0  0  0  0 39 30 30 30 30 30 30 30 30 30 30 30 41  0  0  0  0  0 31 31 31 31 31 31 31 37  0  0  0  0  0  0  0  0  0  0  0  0  0  0  0  0  0  0  0  0  0 57
31 31 31 31 31 31 31 19 31 31 31 31 31 31 31 33 30 32  0  0  0  5  0  0  0  0  0  0  0  0  0  0  0  0  0  0  0  0  0  0  0  0  6  7  0  0  0  0 10  0  0  0  0  0  0  4  0  0  0  0  0  0  0  0  8 48  0  6  7  0  0  0  0  0  0  0  0  0  0  0  0  0  0  0  0  0  0  0  0  0  0  0  0  8  0  0  0 39 30 41  0  0 36 31 19 31 31 31 31 31 31 31 31 31 37  0  0  0  0 31 31 31 31 31 31 31 31 37  0  0  0  0  0  0  0  0  0  0  0  0  0  0  0  0  0  0  0  0  0 57
31 31 31 31 31 31 31 31 31 31 31 31 31 31 31 31 31 33 30 32  0  4  0  0  0  0  0  0  0  0  0  0  0  0  0 11  0  0  0  0  0 39 30 30 30 30 30 30 30 30 30 30 41  0  0 39 30 30 30 30 30 30 30 30 30 30 30 30 30 30 30 30 30 30  0  0  0  0  0  0  0  0  0  0 12  6  7 13  0  0  0  0 39 30 41  0  0 36 31 37  0  0 36 31 31 31 31 31 31 31 31 31 31 31 37  0  0  0  0  0 31 31 31 31 31 31 31 37  0  0  0  0  0  0  0  0  0  0  0  0  0  0  0  0  0  0  0  0  0 57
31 31 31 31 31 31 31 31 31 31 31 31 31 31 31 31 31 31 31 33 30 30 41  0  0  0  0  0  0  8  0  0  0  0 39 30 41  0  0  0  0 36 31 31 31 31 31 31 31 31 31 31 37  0  0 36 31 31 31 31 31 31 31 31 31 31 31 31 31 31 31 31 31 37  0  0  0  0  0  0  0  0  0 39 30 30 30 30 41  0  0  0 36 31 37  0  0 36 31 37  0  0 36 31 31 31 31 31 31 31 31 31 31 31 37  0  0  0  0  0 31 31 31 31 31 31 31 37  0  0  0  0  0  0  0  0  0  0  0  0  0  0  0  0  0  0  0  0  0 57
31 31 31 31 31 31 31 31 31 31 31 31 31 31 31 31 31 31 31 31 31 31 37  0  0  0  0  0 39 30 41  0  0  0 36 19 37  0  0  0  0 36 31 31 31 31 31 31 31 31 31 31 37  0  0 36 31 31 31 31 31 31 31 31 31 31 31 31 31 31 31 31 31 37  0  0  0  0  0  0  0  0  0 36 31 31 31 31 37  0  0  0 35 40 38  0  0 36 31 37  0  0 36 31 31 31 31 31 31 31 31 31 31 31 37  0  0  0  0 31 31 31 31 31 31 31 31 37  0  0  0  0  0  0  0  0  0  0  0  0  0  0  0  0  0  0  0  0  0 57
31 31 31 31 31 31 31 31 31 31 31 31 31 31 31 31 31 31 31 31 31 31 37  0  0  0  0  0 36 31 37  0  0  0 35 40 38  0  0  0  0 36 31 31 31 31 31 31 31 31 31 31 37  0  0 36 31 31 31 31 31 31 31 31 31 31 31 31 31 31 31 31 31 37  0  0  0  0  0  0  0  0  0 36 31 31 31 31 37  0  0  0  0  0  0  0  0 36 31 37  0  0 36 31 31 31 31 31 31 31 31 31 31 31 37  0  0  0  0  0 31 31 31 31 31 31 31 37  0  0  0  0  0  0  0  0  0  0  0  0  0  0  0  0  0  0  0  0  5 57
31 31 31 31 31 31 31 31 31 31 31 31 31 31 31 31 31 31 31 31 31 31 37  0  0  0  0  0 35 40 38  0  0  0  0  0  0  0  0  0  0 36 31 31 31 31 31 31 31 31 31 31 37  0  0 36 31 31 31 31 31 31 31 31 31 31 31 31 31 31 31 31 31 37  0  0  0  0  0  0  0 39 30 31 31 31 31 31 37  0  0  0  0  0  0  0  0 36 31 37  0  0 35 40 40 40 40 40 40 40 40 40 40 40 38  0  0  0  6  7 31 31 31 31 31 31 31 37  0  0  0  0  0  0  0  0  0  0  0  0 12 13 13 12 13  0  0  0  4 48
31 31 31 31 31 31 31 31 31 31 31 31 31 31 31 31 31 31 31 31 31 31 37  0  0  0  0  0  0  0  0  0  0  0  0  0  0  0  0  0  0 36 31 31 31 31 31 31 31 31 31 31 37  0  0 36 31 31 31 31 31 31 31 31 31 31 31 31 31 31 31 31 31 37  0  0  0  0  0  0  0 36 31 31 31 31 31 31 37  0  0  0  0  0  0  0  0 36 31 37  0  0  0  0  0  0  0  0  0  0  0  0  0  0  0  0  0 39 30 30 31 31 31 31 31 31 31 37  0  0  0  0  0  0  0  0  0  0  0 46 30 30 30 30 30 30 30 30 30 30
31 31 31 31 31 31 31 31 31 31 31 31 31 31 31 31 31 31 31 31 31 31 37  0  0  0  0  0  0  0  0  0  0  0  0  0  0  0  0  0  0 36 31 31 31 31 31 31 31 31 31 31 37  0  0 36 31 31 31 31 31 31 31 31 31 31 31 31 31 31 31 31 31 37  0  0  0  0  0  0  0 36 31 31 31 31 31 31 37  0  0  0  0  0  0  0  0 36 31 37  0  0  0  0  0  0  0  0  0  0  0  0  0  0  0  0  0 36 31 31 31 31 31 31 31 31 31 37  0  0  0  0  0  0  0  0  0 11  0 42 31 31 31 31 31 31 31 31 31 31
31 31 31 31 31 31 31 31 31 31 31 31 31 31 31 31 31 31 31 31 31 31 37  0  0  0  0  0  0  0  0  0  0  0  0  0  0  0  0  0  0 36 31 31 31 31 31 31 31 31 31 31 37  0  0 36 31 31 31 31 31 31 31 31 31 31 31 31 31 31 31 31 31 37  0  0  0  0 39 30 30 31 31 31 31 31 31 31 37  0  0  0  0  0  0  0  0 36 31 37  0  0 14  0  0  0  0  0  0  0  0  0  0  0  0  0 14 36 31 31 31 31 31 31 31 31 31 37  0  0  0  0  0  0  0  0 46 30 30 47 31 31 31 31 31 19 31 31 31 31
31 31 31 31 31 31 31 31 31 31 31 31 31 31 31 31 31 31 31 31 31 31 37  0  0  0  0  0  0  0  0  0  0  0  0  0  0  0  0  0  0 36 31 31 31 31 31 31 31 31 31 31 37  0  0 35 40 40 40 40 40 40 40 40 40 40 40 40 40 40 40 40 40 38  0  0  0  0 36 31 31 31 31 31 31 31 31 31 37  0  0  0  0  0  0  0  0 36 31 31 44 44 44 44 44 44 44 44  0  0 44 44 44 44 44 44 44 31 31 31 31 31 31 31 19 31 31 37  0  0  0  0  0  0  0  0 42 31 31 31 31 31 31 31 31 31 31 31 31 31
31 31 31 31 31 31 31 31 31 31 31 31 31 31 31 31 31 31 31 31 31 31 37  0  0  0  0  0  0  0  0  0  0  0  0  0  0  0  0  0  0 36 31 31 31 31 31 31 31 31 31 31 37  0  0  0  0  0  0  0  0  0  0  0  0  0  0  0  0  0  0  0  0  0  0  0  0  0 36 31 31 31 31 31 31 31 31 31 37  0  0  0  0  0  0  0  0 36 31 31 31 31 31 31 31 31 31 37  0  0 36 31 31 31 31 31 31 31 31 31 31 31 31 31 31 31 31 37  0  0  0  0  0  0 46 30 47 31 31 31 31 31 31 31 31 31 31 31 31 31
31 31 31 31 31 31 31 31 31 31 31 31 31 31 31 31 31 31 31 31 31 31 37  0  0  0  0  0  0  0  0  0  0  0  0  0  0  0  0  0  0 36 31 31 31 31 31 31 31 31 31 31 37  0  0  0  0  0  0  0  0  0  0  0  0  0  0  0  0  0  0  0  0  0  0  0 39 30 31 31 31 31 31 31 31 31 31 31 37  0  0  0  0  0  0  0  0 36 31 31 31 31 31 31 31 31 31 37  0  0 36 31 31 31 31 31 31 31 31 31 31 31 31 31 31 31 31 37  0  0  0  0  0  8 42 31 31 31 31 31 31 31 31 31 31 31 31 31 31 31
31 31 31 31 31 31 31 31 31 31 31 31 31 31 31 31 31 31 31 31 31 31 37  0  0  0  0  0  0  0  0  0  0  0  0  0  0  0  0  0  0 36 31 31 31 31 31 31 31 31 31 31 37  0 14  0  0  0  0  0  0  0  0  0  0  0  0  0  0  0  0  0  0  0  0 14 36 31 31 31 31 31 31 31 31 31 31 31 37  0  0  0  0  0  0  0  0 36 31 31 19 31 31 31 31 31 31 37  0  0 36 31 31 31 31 19 31 31 31 31 31 31 31 31 31 31 31 37  0  0  0  0 46 30 47 31 31 31 31 31 31 31 31 31 31 31 31 31 31 31
31 31 31 31 31 31 31 31 31 31 31 31 31 31 31 31 31 31 31 31 31 31 37  0  0  0  0  0  0  0  0  0  0  0  0  0  0  0  0  0  0 36 31 31 31 31 31 31 31 31 31 31 45 44 44 44 44 44 44 44 44 44 44 44 44 44 44 44  0  0  0 44 44 44 44 44 31 31 19 31 31 31 31 31 31 31 31 31 37  0  0  0  0  0  0  0  0 36 31 31 31 31 31 31 31 31 31 37  0  0 35 40 40 40 40 40 40 40 40 40 40 40 40 40 40 40 40 38  0  0  0  0 42 31 31 31 31 31 31 31 31 31 31 31 31 31 31 31 31 31
31 31 31 31 31 31 31 31 31 31 31 31 31 31 31 31 31 31 31 31 31 31 37  0  0  0  0  0  0  0  0  0  0  0  0  0  0  0  0  0  0 36 31 31 31 31 31 31 31 31 31 31 31 31 31 31 31 31 31 31 31 31 31 31 31 31 31 31  0  0  0 31 31 31 31 31 31 31 31 31 31 31 31 31 31 31 31 31 37  0  0  0  0  0  0  0  0 36 31 31 31 31 31 31 31 31 31 37  0  0  0  0  0  0  0  0  0  0  0  0  0  0  0  0  0  0  0  0  0  0 46 30 47 31 31 31 31 31 31 31 31 31 31 31 31 31 31 31 31 31
31 31 31 31 31 31 31 31 31 31 31 31 31 31 31 31 31 31 31 31 31 31 37  0  0  0  0  0  0  0  0  0  0  0  0  0  0  0  0  0  0 36 31 31 31 31 31 31 31 31 31 31 31 31 31 31 19 31 31 31 31 31 31 31 31 31 31 31  0  0  0 31 31 31 31 31 31 31 31 31 31 31 31 31 31 31 31 31 37  0  0  0  0  0  0  0  0 36 31 31 31 31 31 31 31 31 31 37  0  0  0  0 14  0  0  0  0  0  0  0  0  0  0  0 14  0  0  0  0  0 42 31 31 31 31 31 31 31 31 31 31 31 31 31 31 31 31 31 31 31
31 31 31 31 31 31 31 31 31 31 31 31 31 31 31 31 31 31 31 31 31 31 37  0  0  0  0  0  0  0  0  0  0  0  0  0  0  0  0  0  0 36 31 31 31 31 31 31 31 31 31 31 31 31 31 31 31 31 31 31 31 31 31 31 31 31 31 31  0  0  0 31 31 31 31 31 31 31 31 31 31 31 31 31 31 31 31 31 37  0  0  0  0  0  0  0  0 36 31 31 31 31 31 31 31 31 31 37  0  0 44 44 44 44 44 44 44 44 44 44 44 44 44 44 44 44 44 44 44 44 31 31 31 31 31 31 31 31 31 31 31 31 31 31 31 31 30 31 31 31