13
11
0 0 0 0 0 0 0 0 0 0 0 0 0
0  0  0  0  0  0  0  0  0  0  0  0 0
0  0  0  0  0  0  0  0  0  0  0  0 0
38  0  0  0  0  0  0  0  0  0  0  0 38
37  0  0  0  0  0  0  0  0  0  0  0 37
37  0  0  0  0  0  0  0  0  0  0  0 37
36  0  0  0  0  0  0  0  0  0  0  0 36
30  0  0  0  0  0  0  0  0  0  0  0 30
30  0  0  0  0  0  0  0  0  0  0  0 30
30  0  0  0  0  0  0  0  0  0  0  0 30
30 31 31 31 31 31 31 31 31 31 31 31 30